[
["m", "m", "m", "m", "m", "m", "m", "m", "m", "m", "m", "m", "m", "m", "m", "m"],
[["P", "tonel", "right"], " ", " ", " ", " ", " ", " ", " ", " ", " ", " ", " ", " ", " ", " ", "m"],
[["P", "tonel", "right"], " ", " ", " ", " ", " ", " ", " ", " ", " ", " ", " ", " ", " ", " ", "m"],
["m", " ", "s", "s", " ", "s", " ", " ", " ", ["H", "home"], " ", " ", " ", " ", " ", "m"],
["m", " ", " ", "s", "s", "s", " ", " ", " ", " ", "s", " ", " ", " ", " ", "m"],
["m", " ", " ", " ", " ", " ", " ", " ", " ", " ", " ", " ", " ", " ", " ", "m"],
["m", " ", " ", " ", " ", " ", " ", " ", " ", " ", " ", " ", " ", " ", " ", "m"],
["m", " ", " ", " ", " ", " ", " ", "s", " ", " ", " ", "s", " ", " ", " ", "m"],
["m", " ", " ", " ", " ", " ", " ", " ", " ", "s", " ", " ", " ", " ", " ", "m"],
["m", " ", " ", " ", " ", " ", " ", " ", " ", " ", " ", " ", " ", " ", " ", "m"],
["m", " ", " ", " ", " ", " ", " ", " ", " ", "s", " ", " ", " ", " ", " ", "m"],
["m", " ", " ", " ", " ", " ", " ", " ", " ", " ", " ", "s", " ", " ", " ", "m"],
["m", " ", " ", " ", " ", " ", " ", " ", " ", " ", "s", " ", " ", " ", " ", "m"],
["m", " ", " ", " ", " ", " ", " ", " ", " ", " ", " ", " ", " ", " ", " ", "m"],
["m", " ", " ", " ", " ", " ", " ", " ", " ", " ", " ", " ", " ", " ", " ", "m"],
["m", " ", " ", " ", " ", " ", " ", " ", " ", " ", " ", " ", " ", " ", " ", "m"],
["m", " ", " ", " ", " ", " ", " ", " ", " ", " ", " ", " ", " ", " ", " ", "m"],
["m", " ", " ", " ", " ", " ", " ", " ", " ", " ", " ", " ", " ", " ", " ", "m"],
["m", " ", " ", " ", " ", " ", " ", " ", " ", " ", " ", " ", " ", " ", " ", "m"],
["m", " ", " ", " ", " ", " ", " ", " ", " ", " ", " ", " ", " ", " ", " ", "m"],
["m", " ", " ", " ", " ", " ", " ", " ", " ", " ", " ", " ", " ", " ", " ", "m"],
["m", " ", " ", " ", " ", " ", " ", " ", " ", " ", " ", " ", " ", " ", " ", "m"],
["m", " ", " ", " ", " ", " ", " ", " ", " ", " ", " ", " ", " ", " ", " ", "m"],
["m", " ", " ", " ", " ", " ", " ", " ", " ", " ", " ", " ", " ", " ", " ", "m"],
["m", " ", " ", " ", " ", " ", " ", " ", " ", " ", " ", " ", " ", " ", " ", "m"],
["m", " ", " ", " ", " ", " ", " ", " ", " ", " ", " ", " ", " ", " ", " ", "m"],
["m", "m", "m", "m", "m", "m", "m", "m", "m", "m", "m", "m", "m", "m", "m", "m"]
]